1  1  1  1  1  1  1  1  1  1  1  1  1  6  1  1  5  1  1  6  1  1  1  13 13 13 13 13 13 13 13 13 13 13 13 13 13 13 13 13
1  0  0  0  0  0  1  0  0  0  1  0  0  0  0  0  0  0  0  0  0  1  13 1  1  1  0  0  0  0  0  0  0  0  0  0  0  0  0  13
1  0  0  0  0  0  99 0  0  0  1  0  0  0  0  0  0  0  0  0  0  1  13 1  1  1  0  0  1  0  0  1  0  0  1  0  1  0  0  13
1  0  0  0  0  0  1  1  1  0  1  1  1  6  1  1  0  1  1  6  1  1  1  1  1  1  0  1  1  0  1  1  1  0  1  0  1  0  0  13
1  0  0  0  0  1  0  1  0  0  1  1  0  0  0  0  0  0  0  0  0  0  0  0  0  1  0  1  0  0  0  0  1  0  1  0  1  1  0  13
1  0  1  2  1  1  0  1  0  0  1  2  0  0  0  9  10 9  0  0  1  1  1  1  0  1  0  1  0  1  1  0  1  1  1  0  0  0  0  13
1  0  1  1  1  0  0  1  0  0  1  2  0  0  0  0  0  0  0  0  1  0  0  18 17 1  0  0  0  1  0  0  1  0  0  0  1  1  0  13
1  0  0  0  0  0  0  1  0  0  1  1  0  0  0  0  0  0  0  0  1  0  0  18 0  18 0  1  0  1  1  1  1  0  1  1  0  0  0  13
1  0  0  0  1  1  1  1  0  0  1  1  1  1  1  1  0  1  1  1  1  0  0  18 0  18 0  1  0  0  0  0  0  0  0  0  0  1  0  13
1  0  0  0  1  1  1  1  0  0  0  0  0  0  1  9  99 9  0  0  0  0  0  18 0  1  1  1  1  1  1  0  1  1  1  1  1  0  0  13
1  1  1  1  1  1  1  0  0  9  10 9  9  0  9  9  0  9  9  9  9  9  9  18 0  0  0  0  0  0  0  0  0  0  0  0  1  0  0  13
13 15 14 15 14 13 0  0  1  1  9  0  0  0  0  0  0  0  0  0  0  0  9  9  1  1  0  1  1  1  1  0  1  0  1  0  0  0  1  13
15 0  0  0  0  13 0  0  1  9  0  0  0  0  0  0  0  0  0  0  0  0  0  9  0  1  0  1  0  0  1  0  1  0  1  0  1  0  1  13
14 0  0  0  0  13 0  0  1  1  10 0  0  0  0  0  0  0  0  0  0  0  10 9  0  0  0  1  0  0  0  0  1  0  1  0  0  0  1  13
15 0  0  0  0  0  0  0  1  1  10 0  0  0  0  0  0  0  0  0  0  0  9  18 1  1  1  1  0  1  1  1  1  0  0  0  1  1  1  13
14 0  13 15 13 13 0  0  1  9  0  0  0  0  0  0  0  0  0  0  0  0  0  9  0  0  0  1  0  0  0  0  0  0  1  0  1  1  0  13
15 0  0  0  0  13 0  0  1  1  10 0  0  0  0  0  0  0  0  0  0  0  9  18 0  1  0  99 0  1  1  1  0  0  1  0  0  0  0  13
14 0  0  0  0  13 0  0  0  0  0  0  9  0  9  10 12 9  9  0  9  9  1  18 0  1  0  1  0  0  0  0  1  0  0  0  1  1  1  13
1  13 13 13 13  1 1  1  1  1  1  1  1  9  9  9  9  9  9  9  9  9  13 13 13 13 13 13 13 13 13 13 13 13 13 13 13 13 13 13
